100111111001
111111111111
101011111010
001111111100
011111111110
111111111111
101010010101
001111111100
111111111111