100110011001
111111111111
101010101010
001111111100
000011110000