100110011001
111111111111
101010101010
001111111100
011111111110
111111111111
101010010101
000011110000